################################
# ............                 #
# ############ #################
#                              #
#   #### #############         #
#      # #                     #
#      # #############         #
#                              #
################################